5555555555555556.........................5555555........555555555555555555555555555555555555555555555555555555
5555555555555556.........H...........H...8555558........555555555555555555555555555555555555555555555555555555
5555555555555556............D.....D.......88888.........588888888888888888888888855555555..%%%%%%%%%%%%%%%%%45
8888888888888889...............D.....D......%...........5%%%.....%...............55555555...0..0............45
............................................D.......12225.....#.....#....D.......55555555...................45
...........................................D.D......78888.....22222222222222222..%%%%%%%%...................78
............................................D.................5555555555555555..............##########........
.A....#...####....#...0......0..#...F...B........#G........B##5555555555555555.............&5555555555...F....
22222222222222222223............1222222223......122222222222225555555555555555.............&555555555522222222
