5555555555555555555555555
5888888888885555555555555
5...........8855555555555
5.............88555555555
5.......E.......885555555
..................4555555
A.......C.........4555555
22..222222........4555555
555555555522......4555555
55555555555523....4555555
55555555555556....4555555
55555555555556....4555555
55555555555556....4555555
